{
  "level": 1823,
  "hard": false,
  "rows": 19,
  "cols": 19,
  "palette": {
    "C": "#00d2d3",
    "G": "#2ed573",
    "O": "#ff9f43",
    "Y": "#ffd700"
  },
  "grid": [
    "...................",
    "...................",
    ".....Y.............",
    ".....YOO...........",
    ".....OOCC..........",
    ".....OCCGGG........",
    ".....CCGGGGGC......",
    ".....CGGYYYGGCC....",
    ".....GGYYOYYGGCO...",
    ".....GGYOOOYGGCOYY.",
    ".....GGYYOYYGGCO...",
    ".....CGGYYYGGCC....",
    ".....CCGGGGGC......",
    ".....OCCGGG........",
    ".....OOCC..........",
    ".....YOO...........",
    ".....Y.............",
    "...................",
    "..................."
  ],
  "story": "🔷 보석",
  "dialogue": null
}