{
  "level": 1759,
  "hard": false,
  "rows": 19,
  "cols": 19,
  "palette": {
    "N": "#ff8fc7",
    "O": "#ff9f43",
    "P": "#c44dff",
    "R": "#ff4757"
  },
  "grid": [
    ".........N.........",
    ".....PORNPNR.......",
    "....PORNPO.........",
    "...PORNPO..........",
    "..PORNPO...........",
    ".PORNPO............",
    ".ORNPOR............",
    ".RNPORN............",
    ".NPORN.............",
    "NPORNP.............",
    ".NPORN.............",
    ".RNPORN............",
    ".ORNPOR............",
    ".PORNPO............",
    "..PORNPO...........",
    "...PORNPO..........",
    "....PORNPO.........",
    ".....PORNPNR.......",
    ".........N........."
  ],
  "story": "🌙 초승달",
  "dialogue": null
}